0 0 0 0 0 0 0 0 0 0 0 0 0 0 0 0 0 0 0 0 0 0 0 0 0 0 0 0 0 0 0 0 0 0 0 0 0 0 0 0 0 0 0 0 0 0 0 0 0 0 
0 0 0 0 0 0 0 0 0 0 0 0 0 0 0 0 0 0 0 0 0 0 0 0 0 0 0 0 0 0 0 0 0 0 0 0 0 0 0 0 0 0 0 0 0 0 0 0 0 0 
0 0 0 0 0 0 0 0 1 0 0 0 0 0 0 0 0 0 0 0 0 0 0 0 0 0 0 0 0 0 0 0 0 0 0 0 0 0 0 0 0 63 0 0 0 0 0 0 0 0 
0 0 0 0 0 0 0 1 1 1 0 0 0 0 0 0 0 0 0 0 0 0 0 0 0 0 0 0 0 0 0 0 0 0 0 0 0 0 0 0 9 28 52 0 0 0 0 0 0 0 
0 0 0 0 0 0 0 1 1 9 1 0 0 0 0 0 0 0 0 0 0 0 0 0 0 0 0 0 0 0 0 0 0 0 0 0 0 0 0 43 3 51 3 1 0 0 0 0 0 0 
0 0 0 0 0 0 1 1 1 1 1 1 0 0 0 0 0 0 0 0 0 0 0 0 0 0 0 0 0 0 0 0 0 0 0 0 0 0 1 29 3 6 6 56 0 0 0 0 0 0 
0 0 0 0 0 7 1 45 6 62 1 6 1 0 0 0 0 0 0 0 0 0 0 0 0 0 0 0 0 0 0 0 0 0 0 0 0 1 1 1 1 1 9 1 1 0 0 0 0 0 
0 0 0 0 9 10 3 13 29 1 9 51 1 1 0 0 0 0 0 0 0 0 0 0 0 0 0 0 0 0 0 0 0 0 0 0 1 6 1 23 1 22 1 20 1 1 0 0 0 0 
0 0 0 0 63 53 123 66 66 123 123 123 28 1 1 0 0 0 0 0 0 0 0 0 0 0 0 0 0 0 0 0 0 0 0 1 29 3 1 49 1 46 1 41 1 1 0 0 0 0 
0 0 0 42 10 18 132 66 66 143 144 132 55 1 1 1 0 0 0 0 0 0 0 0 0 0 0 0 0 0 0 0 0 0 1 2 26 56 1 1 1 1 1 4 1 1 8 0 0 0 
0 0 0 9 51 31 47 1 1 5 1 50 1 1 1 1 2 1 1 1 1 2 56 1 1 1 1 1 1 1 1 1 1 1 123 123 136 123 136 123 66 66 1 1 48 50 30 0 0 0 
0 0 0 1 29 1 1 62 15 1 51 1 9 1 43 30 13 13 14 16 30 16 15 14 13 30 14 16 30 29 13 14 29 1 132 120 120 144 120 141 66 66 123 1 21 20 64 0 0 0 
0 0 0 1 14 34 35 29 1 123 123 123 123 1 30 21 23 22 21 20 22 28 20 20 22 20 20 22 64 63 23 27 45 1 17 1 1 39 8 1 1 49 143 136 152 136 123 0 0 0 
0 0 0 123 66 66 123 123 123 132 132 132 132 1 25 26 46 6 1 1 1 1 1 1 1 3 52 24 63 57 1 55 1 8 1 42 1 16 14 53 1 1 1 132 132 141 132 0 0 0 
0 0 0 132 66 66 132 132 132 1 1 1 1 1 18 35 8 17 47 4 1 1 1 1 1 3 5 7 16 62 43 1 1 1 5 1 28 1 27 1 1 6 1 1 1 1 1 0 0 0 
0 0 0 55 1 1 1 1 1 1 1 1 1 1 28 12 1 2 7 24 1 1 1 1 1 6 1 1 59 26 18 1 1 1 1 7 1 1 1 1 10 51 1 7 1 29 1 0 0 0 
0 0 0 1 1 3 30 14 16 13 13 16 14 13 34 26 1 1 1 1 1 1 1 24 46 9 1 1 34 35 25 1 1 1 3 10 42 1 1 1 1 8 1 18 12 17 1 0 0 0 
0 0 0 50 10 6 21 20 23 22 21 20 20 22 28 22 1 1 5 1 1 1 1 1 1 1 1 1 63 64 1 1 1 1 1 1 1 1 1 1 1 1 1 11 35 1 1 0 0 0 
0 0 0 0 51 7 1 1 1 1 1 1 1 1 1 1 1 1 39 45 42 1 1 1 1 1 1 1 61 62 1 1 1 150 123 123 1 1 1 1 1 1 1 11 19 1 0 0 0 0 
0 0 0 0 1 1 19 7 1 1 8 1 1 1 1 17 1 1 1 123 66 66 145 123 123 123 123 42 1 1 55 123 123 132 132 132 1 1 1 1 1 123 1 34 1 1 0 0 0 0 
0 0 0 0 1 1 26 5 1 1 1 46 1 1 13 16 34 1 1 142 66 66 146 148 144 132 132 1 1 1 1 132 132 51 14 27 1 1 1 1 1 132 1 27 19 1 0 0 0 0 
0 0 0 1 1 123 1 1 1 1 38 6 1 1 22 22 20 1 1 8 1 1 1 1 1 1 1 4 1 1 1 1 1 9 4 47 1 1 1 1 1 1 1 1 1 1 1 0 0 0 
0 0 0 1 1 132 123 66 66 123 123 123 1 1 1 2 1 1 1 50 1 1 1 1 10 1 2 1 50 45 52 1 1 5 6 1 1 1 1 1 1 1 45 1 1 1 1 0 0 0 
0 0 0 1 9 7 132 66 66 132 132 132 1 1 29 52 18 1 1 1 1 4 1 41 1 52 1 1 46 1 1 1 39 10 11 1 66 66 1 1 1 4 1 9 1 1 1 0 0 0 
0 0 0 1 63 1 49 1 1 1 1 9 1 15 34 1 1 27 1 1 5 1 6 1 1 1 1 1 3 1 24 1 1 46 31 1 66 66 1 1 1 1 1 1 1 1 1 0 0 0 
0 0 0 1 44 3 4 10 5 1 48 1 28 22 21 1 1 1 1 10 1 1 24 46 24 49 1 1 1 1 1 1 1 1 4 49 1 1 1 1 1 1 1 1 1 1 1 0 0 0 
0 0 0 38 1 1 123 152 123 152 147 147 152 150 150 123 1 1 1 8 9 1 1 1 1 1 1 1 10 1 7 1 24 1 6 9 10 1 1 1 1 1 1 1 17 1 1 0 0 0 
0 0 0 1 6 9 132 151 142 132 143 146 148 132 144 132 1 1 1 9 51 38 38 1 1 3 1 1 3 1 1 45 47 5 1 1 1 1 39 43 1 1 1 8 38 1 1 0 0 0 
0 0 0 45 1 5 1 1 46 1 1 23 49 10 28 64 1 1 1 1 1 39 1 3 1 1 1 10 1 1 1 1 1 1 1 1 1 1 1 60 1 1 50 1 7 1 1 0 0 0 
0 0 0 0 1 1 1 1 1 1 24 1 24 29 39 1 1 1 1 1 1 16 14 1 1 1 6 7 1 1 1 1 1 1 1 1 1 1 1 39 1 123 123 123 150 123 0 0 0 0 
0 0 0 0 1 42 1 52 9 47 39 1 1 1 1 1 123 123 152 123 1 11 12 1 150 123 123 123 145 123 66 66 149 150 145 123 150 123 39 57 1 132 132 132 143 144 0 0 0 0 
0 0 0 0 27 7 1 2 1 3 1 41 9 1 1 1 132 143 132 143 1 31 32 1 132 132 142 132 141 132 66 66 132 142 132 132 141 132 51 9 42 38 1 1 53 0 0 0 0 0 
0 0 0 0 0 0 56 6 3 7 1 1 1 1 1 5 47 49 1 1 1 25 35 15 13 14 16 29 1 6 1 9 47 1 1 38 1 1 7 6 56 7 8 1 1 0 0 0 0 0 
0 0 0 0 0 0 1 1 1 1 3 1 1 1 1 10 1 1 7 1 1 28 21 22 23 20 22 27 7 1 4 1 1 8 10 1 55 1 123 145 123 1 49 1 34 0 0 0 0 0 
0 0 0 0 0 0 1 123 123 123 123 123 123 166 123 123 123 123 123 123 123 123 123 123 123 123 123 123 123 123 66 66 123 123 123 123 166 123 132 132 132 123 123 1 0 0 0 0 0 0 
0 0 0 0 0 0 0 132 132 132 132 132 132 167 132 132 132 132 132 132 132 132 132 132 132 132 132 132 132 132 66 66 132 132 132 132 167 132 132 132 132 132 132 0 0 0 0 0 0 0 
0 0 0 0 0 0 0 1 1 1 1 1 1 1 1 5 51 10 1 44 1 1 39 1 4 2 2 49 1 1 1 46 1 43 4 9 1 1 1 19 1 1 1 0 0 0 0 0 0 0 
0 0 0 0 0 0 0 50 1 8 1 52 16 13 15 16 39 1 1 3 29 50 1 1 1 23 27 1 1 30 63 27 1 63 22 23 64 1 1 1 27 1 10 0 0 0 0 0 0 0 
0 0 0 0 0 0 0 4 5 1 1 28 23 22 20 21 9 1 1 1 1 1 1 1 1 1 1 1 50 27 26 34 1 5 51 2 30 8 1 1 1 8 47 0 0 0 0 0 0 0 
0 0 0 0 0 0 0 48 7 7 1 10 1 1 5 1 1 1 1 1 1 1 1 1 1 1 1 1 39 35 32 42 1 1 24 1 1 1 1 1 1 1 10 0 0 0 0 0 0 0 
0 0 0 0 0 0 0 0 1 1 6 9 1 1 1 1 1 6 8 61 63 22 23 20 23 20 21 21 23 21 60 1 5 1 1 7 1 49 1 1 1 1 0 0 0 0 0 0 0 0 
0 0 0 0 0 0 0 0 123 123 123 123 123 123 123 123 123 123 28 38 55 44 50 42 45 42 1 56 9 4 45 27 123 123 123 123 123 123 123 123 123 123 0 0 0 0 0 0 0 0 
0 0 0 0 0 0 0 0 132 132 132 132 132 132 132 132 132 132 29 46 39 49 1 6 28 64 5 52 6 4 43 30 132 132 132 132 132 132 132 132 132 132 0 0 0 0 0 0 0 0 
0 0 0 0 0 0 0 0 0 0 0 0 0 0 0 0 0 0 26 1 47 4 55 43 49 10 46 45 53 6 38 18 0 0 0 0 0 0 0 0 0 0 0 0 0 0 0 0 0 0 
0 0 0 0 0 0 0 0 0 0 0 0 0 0 0 0 0 0 19 30 8 43 51 53 17 45 1 51 9 48 46 25 0 0 0 0 0 0 0 0 0 0 0 0 0 0 0 0 0 0 
0 0 0 0 0 0 0 0 0 0 0 0 0 0 0 0 0 0 35 1 44 41 42 1 44 52 47 2 49 55 1 34 0 0 0 0 0 0 0 0 0 0 0 0 0 0 0 0 0 0 
0 0 0 0 0 0 0 0 0 0 0 0 0 0 0 0 0 0 0 145 1 1 1 1 1 1 1 1 1 1 123 123 0 0 0 0 0 0 0 0 0 0 0 0 0 0 0 0 0 0 
0 0 0 0 0 0 0 0 0 0 0 0 0 0 0 0 0 0 0 143 150 147 147 166 166 166 166 147 147 150 118 132 0 0 0 0 0 0 0 0 0 0 0 0 0 0 0 0 0 0 
0 0 0 0 0 0 0 0 0 0 0 0 0 0 0 0 0 0 0 0 141 142 151 167 167 167 167 142 151 144 0 0 0 0 0 0 0 0 0 0 0 0 0 0 0 0 0 0 0 0 
0 0 0 0 0 0 0 0 0 0 0 0 0 0 0 0 0 0 0 0 0 0 0 0 0 0 0 0 0 0 0 0 0 0 0 0 0 0 0 0 0 0 0 0 0 0 0 0 0 0 
