0 0 0 0 0 0 0 0 0 0 0 0 0 0 0 0 0 0 0 0 0 0 0 0 0 0 0 0 0 0 0 0 0 0 0 0 0 0 0 0 0 0 0 0 0 0 0 0 0 0 
0 0 0 0 0 0 0 0 0 0 0 0 0 0 0 0 0 0 0 0 0 0 0 0 0 0 0 0 0 0 0 0 0 0 0 0 0 0 0 0 0 0 0 0 0 0 0 0 0 0 
0 0 0 0 0 0 0 0 1 0 0 0 0 0 0 0 0 0 0 0 0 0 0 0 0 0 0 0 0 0 0 0 0 0 0 0 0 0 0 0 0 63 0 0 0 0 0 0 0 0 
0 0 0 0 0 0 0 1 1 1 0 0 0 0 0 0 0 0 0 0 0 0 0 0 0 0 0 0 0 0 0 0 0 0 0 0 0 0 0 0 9 28 52 0 0 0 0 0 0 0 
0 0 0 0 0 0 0 1 1 1 1 0 0 0 0 0 0 0 0 0 0 0 0 0 0 0 0 0 0 0 0 0 0 0 0 0 0 0 0 43 3 51 3 1 0 0 0 0 0 0 
0 0 0 0 0 0 1 1 1 1 1 1 0 0 0 0 0 0 0 0 0 0 0 0 0 0 0 0 0 0 0 0 0 0 0 0 0 0 1 29 3 6 6 56 0 0 0 0 0 0 
0 0 0 0 0 122 1 1 1 1 1 1 124 0 0 0 0 0 0 0 0 0 0 0 0 0 0 0 0 0 0 0 0 0 0 0 0 1 1 1 1 1 9 1 1 0 0 0 0 0 
0 0 0 0 1 131 1 1 1 1 1 1 133 1 0 0 0 0 0 0 0 0 0 0 0 0 0 0 0 0 0 0 0 0 0 0 1 1 1 1 1 1 1 1 1 1 0 0 0 0 
0 0 0 0 1 1 122 123 123 123 123 124 1 1 1 0 0 0 0 0 0 0 0 0 0 0 0 0 0 0 0 0 0 0 0 1 1 1 1 1 1 1 1 1 1 1 0 0 0 0 
0 0 0 1 1 1 131 132 142 143 144 133 1 1 1 1 0 0 0 0 0 0 0 0 0 0 0 0 0 0 0 0 0 0 1 1 1 1 1 1 1 1 1 1 1 1 1 0 0 0 
0 0 0 1 1 1 15 16 1 1 1 1 1 1 1 1 2 1 1 1 1 1 1 1 1 1 1 1 1 1 1 1 1 1 122 123 136 123 136 123 123 123 1 1 1 1 1 0 0 0 
0 0 0 1 1 1 1 1 1 1 1 1 1 1 1 1 5 1 1 1 1 1 1 1 1 1 1 1 1 1 1 1 1 1 131 120 120 144 120 141 120 142 123 1 1 1 1 0 0 0 
0 0 0 1 1 1 1 1 1 123 123 123 124 1 1 1 5 1 1 1 1 1 1 1 1 2 10 5 1 1 1 1 1 1 1 1 1 1 1 1 15 16 143 136 152 136 124 0 0 0 
0 0 0 122 123 123 123 123 124 132 132 132 133 1 1 2 46 6 1 1 1 1 1 1 1 3 52 24 1 1 1 55 1 1 1 1 1 1 1 1 1 1 1 132 132 141 133 0 0 0 
0 0 0 131 132 132 132 132 133 1 1 1 1 1 1 10 8 17 1 1 1 1 1 1 1 3 5 7 1 1 1 1 1 1 1 1 1 1 1 1 1 1 1 1 1 1 1 0 0 0 
0 0 0 14 15 1 1 1 1 1 1 1 1 1 1 1 1 1 1 1 1 1 1 1 1 1 1 1 1 1 1 1 1 1 1 3 1 1 1 1 1 1 1 1 1 1 1 0 0 0 
0 0 0 1 1 3 1 1 1 1 1 1 1 1 1 1 1 1 1 1 1 1 1 1 1 1 1 1 1 1 1 1 1 1 3 10 42 1 1 1 1 1 1 1 1 1 1 0 0 0 
0 0 0 50 10 6 4 1 1 1 1 1 1 1 1 1 1 1 1 1 1 1 1 1 1 1 1 123 62 64 123 1 1 1 1 1 1 1 1 1 1 1 1 1 1 1 1 0 0 0 
0 0 0 122 51 7 1 1 1 1 1 1 1 1 1 1 1 1 1 1 1 1 1 1 1 1 1 132 35 61 132 1 1 150 123 124 1 1 1 1 1 1 1 1 1 1 124 0 0 0 
0 0 0 131 122 1 1 1 1 1 1 1 1 1 1 1 1 1 1 123 123 123 145 123 123 123 124 1 1 1 1 122 124 132 132 133 1 1 1 1 1 123 124 1 1 124 133 0 0 0 
0 0 0 0 131 1 1 1 1 1 1 1 1 1 1 1 1 1 1 142 143 141 146 148 144 132 133 1 1 1 1 131 133 1 1 1 1 1 1 1 1 132 133 1 1 133 0 0 0 0 
0 0 0 1 1 122 1 1 1 1 1 1 1 1 1 1 1 1 1 1 1 1 1 1 1 1 1 1 1 1 1 1 1 1 1 1 1 1 1 1 1 1 1 1 1 1 1 0 0 0 
0 0 0 1 1 131 1 1 1 1 1 1 1 1 1 1 1 1 1 1 1 1 1 1 1 1 1 1 1 1 1 1 1 1 1 1 1 1 1 1 1 1 1 1 1 1 1 0 0 0 
0 0 0 1 1 1 1 1 1 1 1 1 1 1 1 1 1 1 1 1 1 1 1 97 66 96 1 1 1 1 1 1 1 1 1 1 1 1 1 1 1 1 1 1 1 1 1 0 0 0 
0 0 0 1 1 1 1 1 1 1 1 1 1 1 1 1 1 1 1 1 1 1 1 97 104 67 1 1 1 1 1 1 1 1 1 1 1 1 1 1 1 1 1 1 1 1 1 0 0 0 
0 0 0 1 1 1 1 1 1 1 1 1 1 1 1 1 1 1 1 1 1 1 1 73 74 75 1 1 1 1 1 1 1 1 1 1 14 16 1 1 1 1 1 1 1 1 1 0 0 0 
0 0 0 1 1 1 122 152 123 152 147 147 152 150 150 123 1 1 1 1 1 1 1 1 1 1 1 1 1 1 1 1 1 1 1 1 1 1 1 1 39 1 1 39 1 1 1 0 0 0 
0 0 0 1 1 1 131 151 142 132 143 146 148 132 144 132 1 1 1 1 1 1 1 1 1 1 1 1 1 1 1 1 39 1 1 1 1 1 39 1 1 1 1 1 1 1 1 0 0 0 
0 0 0 1 1 1 1 1 1 1 1 1 1 1 1 1 1 1 1 1 1 1 1 1 1 1 1 1 1 1 1 1 1 1 1 1 1 1 1 1 1 1 1 1 1 1 1 0 0 0 
0 0 0 122 1 1 1 1 1 1 1 1 1 1 1 1 1 1 1 1 1 1 1 1 1 1 1 1 1 1 1 1 1 1 1 1 1 1 1 39 1 123 123 123 150 123 124 0 0 0 
0 0 0 131 122 1 1 1 1 1 1 1 1 1 1 1 122 123 152 123 123 1 1 123 150 123 123 123 145 123 123 123 149 150 145 123 150 123 39 1 1 132 132 132 143 144 133 0 0 0 
0 0 0 0 131 1 1 1 1 1 1 1 1 1 1 1 131 143 132 143 132 1 1 132 132 132 142 132 141 132 141 132 132 142 132 132 141 132 51 9 42 1 1 1 1 133 0 0 0 0 
0 0 0 0 0 122 1 1 1 1 1 1 1 1 1 1 1 1 1 1 1 1 1 1 1 1 1 1 1 1 1 1 1 1 1 1 1 1 7 6 56 1 1 1 124 0 0 0 0 0 
0 0 0 0 0 131 122 1 1 1 1 1 1 1 1 1 1 1 1 1 1 1 1 1 1 1 1 1 1 1 1 1 1 1 1 1 1 1 122 145 124 1 1 124 133 0 0 0 0 0 
0 0 0 0 0 0 131 122 123 123 123 123 123 166 123 123 123 123 123 123 123 123 123 123 123 123 123 123 123 123 123 123 123 123 123 123 166 123 131 132 133 123 124 133 0 0 0 0 0 0 
0 0 0 0 0 0 0 131 132 132 132 132 132 167 132 132 132 132 132 132 132 132 132 132 132 132 132 132 132 132 132 132 132 132 132 132 167 132 132 132 132 132 133 0 0 0 0 0 0 0 
0 0 0 0 0 0 0 1 1 1 1 1 1 1 1 1 1 1 1 1 1 1 1 1 1 1 1 1 1 1 14 15 1 1 1 1 1 1 1 1 1 1 1 0 0 0 0 0 0 0 
0 0 0 0 0 0 0 1 1 1 1 1 1 1 1 1 1 1 1 1 1 1 1 1 1 1 1 1 1 1 1 1 1 1 1 1 1 1 1 1 1 1 1 0 0 0 0 0 0 0 
0 0 0 0 0 0 0 1 1 1 1 1 1 1 1 1 1 1 1 1 1 1 1 1 1 1 1 1 1 1 1 1 1 1 1 1 1 1 1 1 1 1 1 0 0 0 0 0 0 0 
0 0 0 0 0 0 0 1 1 1 1 1 1 1 1 1 1 1 1 1 1 1 1 1 1 1 1 1 1 1 1 1 1 1 1 1 1 1 1 1 1 1 1 0 0 0 0 0 0 0 
0 0 0 0 0 0 0 122 1 1 1 1 1 1 1 1 1 6 8 61 63 22 23 20 23 20 21 21 23 21 60 1 1 1 1 1 1 1 1 1 1 1 124 0 0 0 0 0 0 0 
0 0 0 0 0 0 0 131 122 123 123 123 123 123 123 123 123 123 28 38 24 1 1 1 1 1 1 1 9 4 45 27 123 123 123 123 123 123 123 123 123 124 133 0 0 0 0 0 0 0 
0 0 0 0 0 0 0 0 131 132 132 132 132 132 132 132 132 132 29 46 39 1 1 1 1 1 1 1 6 4 43 30 132 132 132 132 132 132 132 132 132 133 0 0 0 0 0 0 0 0 
0 0 0 0 0 0 0 0 0 0 0 0 0 0 0 0 0 0 26 1 1 1 1 1 1 1 1 1 1 6 38 18 0 0 0 0 0 0 0 0 0 0 0 0 0 0 0 0 0 0 
0 0 0 0 0 0 0 0 0 0 0 0 0 0 0 0 0 0 19 30 1 1 1 1 1 1 1 1 1 1 1 25 0 0 0 0 0 0 0 0 0 0 0 0 0 0 0 0 0 0 
0 0 0 0 0 0 0 0 0 0 0 0 0 0 0 0 0 0 35 1 1 1 1 1 1 1 1 1 1 1 1 34 0 0 0 0 0 0 0 0 0 0 0 0 0 0 0 0 0 0 
0 0 0 0 0 0 0 0 0 0 0 0 0 0 0 0 0 0 122 145 1 1 1 1 1 1 1 1 1 1 123 124 0 0 0 0 0 0 0 0 0 0 0 0 0 0 0 0 0 0 
0 0 0 0 0 0 0 0 0 0 0 0 0 0 0 0 0 0 131 143 150 147 147 166 166 166 166 147 147 150 118 133 0 0 0 0 0 0 0 0 0 0 0 0 0 0 0 0 0 0 
0 0 0 0 0 0 0 0 0 0 0 0 0 0 0 0 0 0 0 0 141 142 151 167 167 167 167 142 151 144 0 0 0 0 0 0 0 0 0 0 0 0 0 0 0 0 0 0 0 0 
0 0 0 0 0 0 0 0 0 0 0 0 0 0 0 0 0 0 0 0 0 0 0 0 0 0 0 0 0 0 0 0 0 0 0 0 0 0 0 0 0 0 0 0 0 0 0 0 0 0 
